000000000000000000000000000000
00000000000000000000000yyyyyuu
000000000000000000000122222223
00000000000000000t000000000000
000000000000000000000000000000
000000000000000000000090000000
0000000000000000000000t0000000
000000000000000000000000700000
0y9000000000074700000000t00000
013000000000122230000000000000
000000000000000000000000000000
000000y70000000000000000000000
00000123000000000000000000t000
000000000000000000009y00000000
000000000000000000012300000000
000000000000474000000000000000
00000y000001222223000000000000
012223000000000000000000000r08
000000000000000000000000000123
666666666666666666666666666666