000000000000000000000000000000
000000000000000000000000000000
000000000000000000000000000000
000000000000000000000000000000
000000000000000000000000000000
000000000000000000000090000000
0000000000000000000000t0000000
000000000000000000000000000000
009000000000070700000000000000
00t00000000012223000000000007y
000000040000000000000000000012
000000123000000000000000000000
0000000000000000000000000t0000
000000000000000000009y00000000
000000000000000000012300000000
000000000007470000000000000000
000000000001230000000000000000
012223000070000000000000000r08
0000000000t0000000000000000123
666666666666666666666666666666