00000000000000000000
00000000000000000000
00000000000000000000
00000000000000000000
00000000000000000000
00000000000000000000
00000000000000000000
00000000000000000000
00000000000000000000
00000000000000000000
00000000000000000000
00000000000400400000
00000000001222223000
00070000020000000000
00020000200000000000
00000000000000000000
00000000000000000000
00000200000000000000
00002000000000000700
12222222222666222223
