00000000000000000000
00000000000000000000
00000000000000000000
00000000000000000000
00000000000000000000
00000000000000000000
00000000000000000000
00000000000000000000
00000000000000000000
00000000000000000000
00000000000000000000
00000000000400400000
00000000001222223000
00000002000000000000
00020002000000000000
00000002000000000000
00000002000000000000
00000002000000000000
00000002220000000000
12222222222666222223
